{
    "available_dates": [
        "1920-01-01",
        "1950-10-01",
        "1955-10-01",
        "1960-10-01",
        "1965-10-01",
        "1970-10-01",
        "1975-10-01",
        "1980-10-01",
        "1985-10-01",
        "1995-10-01",
        "2000-10-01",
        "2005-01-01",
        "2006-01-01",
        "2007-04-01",
        "2007-10-01",
        "2009-03-20",
        "2010-03-29",
        "2011-03-31",
        "2012-04-01",
        "2013-04-01",
        "2014-04-01",
        "2015-01-01",
        "2016-01-01",
        "2017-01-01",
        "2018-01-01",
        "2019-01-01",
        "2020-01-01",
        "2021-01-01"
    ]
}